{
    "D0": {
        "A0A": 1, "A0B": 1, "A0C": 1, "A0D": 1,
        "A1A": 1, "A1B": 1, "A1C": 1, "A1D": 1,
        "A2A": 1, "A2B": 1, "A2C": 1, "A2D": 1,
        "A3A": 1, "A3B": 1, "A3C": 1, "A3D": 1,
        "A4A": 1, "A4B": 1, "A4C": 1, "A4D": 1,
        "D1": 1
    },
    "A0A": {
        "A0B": 1, "A0C": 1, "A0D": 1,
        "A1A": 1, "A1B": 1, "A1C": 1, "A1D": 1,
        "A2A": 1, "A2B": 1, "A2C": 1, "A2D": 1,
        "A3A": 1, "A3B": 1, "A3C": 1, "A3D": 1,
        "A4A": 1, "A4B": 1, "A4C": 1, "A4D": 1,
        "D1": 1
    },
    "A0B": {
        "A0C": 1, "A0D": 1,
        "A1A": 1, "A1B": 1, "A1C": 1, "A1D": 1,
        "A2A": 1, "A2B": 1, "A2C": 1, "A2D": 1,
        "A3A": 1, "A3B": 1, "A3C": 1, "A3D": 1,
        "A4A": 1, "A4B": 1, "A4C": 1, "A4D": 1,
        "D1": 1
    },
    "A0C": {
        "A0D": 1,
        "A1A": 1, "A1B": 1, "A1C": 1, "A1D": 1,
        "A2A": 1, "A2B": 1, "A2C": 1, "A2D": 1,
        "A3A": 1, "A3B": 1, "A3C": 1, "A3D": 1,
        "A4A": 1, "A4B": 1, "A4C": 1, "A4D": 1,
        "D1": 1
    },
    "A0D": {
        "A1A": 1, "A1B": 1, "A1C": 1, "A1D": 1,
        "A2A": 1, "A2B": 1, "A2C": 1, "A2D": 1,
        "A3A": 1, "A3B": 1, "A3C": 1, "A3D": 1,
        "A4A": 1, "A4B": 1, "A4C": 1, "A4D": 1,
        "D1": 1
    },
    "A1A": {
        "A1B": 1, "A1C": 1, "A1D": 1,
        "A2A": 1, "A2B": 1, "A2C": 1, "A2D": 1,
        "A3A": 1, "A3B": 1, "A3C": 1, "A3D": 1,
        "A4A": 1, "A4B": 1, "A4C": 1, "A4D": 1,
        "D1": 1
    },
    "A1B": {
        "A1C": 1, "A1D": 1,
        "A2A": 1, "A2B": 1, "A2C": 1, "A2D": 1,
        "A3A": 1, "A3B": 1, "A3C": 1, "A3D": 1,
        "A4A": 1, "A4B": 1, "A4C": 1, "A4D": 1,
        "D1": 1
    },
    "A1C": {
        "A1D": 1,
        "A2A": 1, "A2B": 1, "A2C": 1, "A2D": 1,
        "A3A": 1, "A3B": 1, "A3C": 1, "A3D": 1,
        "A4A": 1, "A4B": 1, "A4C": 1, "A4D": 1,
        "D1": 1
    },
    "A1D": {
        "A2A": 1, "A2B": 1, "A2C": 1, "A2D": 1,
        "A3A": 1, "A3B": 1, "A3C": 1, "A3D": 1,
        "A4A": 1, "A4B": 1, "A4C": 1, "A4D": 1,
        "D1": 1
    },
    "A2A": {
        "A2B": 1, "A2C": 1,  "A2D": 1,
        "A3A": 1, "A3B": 1, "A3C": 1, "A3D": 1,
        "A4A": 1, "A4B": 1, "A4C": 1, "A4D": 1,
        "D1": 1
    },
    "A2B": {
        "A2C": 1, "A2D": 1,
        "A3A": 1, "A3B": 1, "A3C": 1, "A3D": 1,
        "A4A": 1, "A4B": 1, "A4C": 1, "A4D": 1,
        "D1": 1
    },
    "A2C": {
        "A2D": 1,
        "A3A": 1, "A3B": 1, "A3C": 1, "A3D": 1,
        "A4A": 1, "A4B": 1, "A4C": 1, "A4D": 1,
        "D1": 1
    },
    "A2D": {
        "A3A": 1, "A3B": 1, "A3C": 1, "A3D": 1,
        "A4A": 1, "A4B": 1, "A4C": 1, "A4D": 1,
        "D1": 1
    },
    "A3A": {
        "A3B": 1, "A3C": 1, "A3D": 1, 
        "A4A": 1, "A4B": 1, "A4C": 1, "A4D": 1,
        "D1": 1
    },
    "A3B": {
        "A3C": 1, "A3D": 1,
        "A4A": 1, "A4B": 1, "A4C": 1, "A4D": 1,
        "D1": 1
    },
    "A3C": {
        "A3D": 1,
        "A4A": 1, "A4B": 1, "A4C": 1, "A4D": 1,
        "D1": 1
    },
    "A3D": {
        "A4A": 1, "A4B": 1, "A4C": 1, "A4D": 1,
        "D1": 1
    },
    "A4A": {
        "A4B": 1, "A4C": 1, "A4D": 1,
        "D1": 1
    },
    "A4B": {
        "A4C": 1, "A4D": 1,
        "D1": 1
    },
    "A4C": {
        "A4D": 1,
        "D1": 1
    },
    "A4D": {
        "D1": 1
    }
}