{
    "D0": {
        "A0A": 1, "A0B": 2, "A0C": 3, "A0D": 4,
        "A1A": 5, "A1B": 4, "A1C": 3, "A1D": 2,
        "A2A": 6, "A2B": 5, "A2C": 4, "A2D": 3,
        "A3A": 7, "A3B": 6, "A3C": 5, "A3D": 4,
        "A4A": 8, "A4B": 7, "A4C": 6, "A4D": 5,
        "D1": 5
    },
    "A0A": {
        "A0B": 1, "A0C": 2, "A0D": 3,
        "A1A": 4, "A1B": 3, "A1C": 2, "A1D": 1,
        "A2A": 5, "A2B": 4, "A2C": 3, "A2D": 2,
        "A3A": 6, "A3B": 5, "A3C": 4, "A3D": 3,
        "A4A": 7, "A4B": 6, "A4C": 5, "A4D": 4,
        "D1": 4
    },
    "A0B": {
        "A0C": 1, "A0D": 2,
        "A1A": 5, "A1B": 4, "A1C": 3, "A1D": 2,
        "A2A": 4, "A2B": 3, "A2C": 2, "A2D": 1,
        "A3A": 5, "A3B": 4, "A3C": 3, "A3D": 2,
        "A4A": 6, "A4B": 5, "A4C": 4, "A4D": 3,
        "D1": 3
    },
    "A0C": {
        "A0D": 1,
        "A1A": 6, "A1B": 5, "A1C": 4, "A1D": 3,
        "A2A": 5, "A2B": 4, "A2C": 3, "A2D": 2,
        "A3A": 4, "A3B": 3, "A3C": 2, "A3D": 1,
        "A4A": 5, "A4B": 4, "A4C": 3, "A4D": 2,
        "D1": 2
    },
    "A0D": {
        "A1A": 7, "A1B": 6, "A1C": 5, "A1D": 4,
        "A2A": 6, "A2B": 5, "A2C": 4, "A2D": 3,
        "A3A": 5, "A3B": 4, "A3C": 3, "A3D": 2,
        "A4A": 4, "A4B": 3, "A4C": 2, "A4D": 1,
        "D1": 1
    },
    "A1A": {
        "A1B": 1, "A1C": 2, "A1D": 3,
        "A2A": 1, "A2B": 2, "A2C": 3, "A2D": 4,
        "A3A": 2, "A3B": 3, "A3C": 4, "A3D": 5,
        "A4A": 3, "A4B": 4, "A4C": 5, "A4D": 6,
        "D1": 8
    },
    "A1B": {
        "A1C": 1, "A1D": 2,
        "A2A": 2, "A2B": 1, "A2C": 2, "A2D": 3,
        "A3A": 3, "A3B": 2, "A3C": 3, "A3D": 4,
        "A4A": 3, "A4B": 2, "A4C": 3, "A4D": 4,
        "D1": 7
    },
    "A1C": {
        "A1D": 1,
        "A2A": 3, "A2B": 2, "A2C": 1, "A2D": 2,
        "A3A": 3, "A3B": 2, "A3C": 1, "A3D": 2,
        "A4A": 3, "A4B": 2, "A4C": 1, "A4D": 2,
        "D1": 6
    },
    "A1D": {
        "A2A": 4, "A2B": 3, "A2C": 2, "A2D": 1,
        "A3A": 4, "A3B": 3, "A3C": 2, "A3D": 1,
        "A4A": 4, "A4B": 3, "A4C": 2, "A4D": 1,
        "D1": 5
    },
    "A2A": {
        "A2B": 1, "A2C": 2,  "A2D": 3,
        "A3A": 1, "A3B": 2, "A3C": 3, "A3D": 4,
        "A4A": 1, "A4B": 2, "A4C": 3, "A4D": 4,
        "D1": 7
    },
    "A2B": {
        "A2C": 1, "A2D": 2,
        "A3A": 2, "A3B": 1, "A3C": 2, "A3D": 3,
        "A4A": 2, "A4B": 1, "A4C": 2, "A4D": 3,
        "D1": 6
    },
    "A2C": {
        "A2D": 1,
        "A3A": 3, "A3B": 2, "A3C": 1, "A3D": 2,
        "A4A": 3, "A4B": 2, "A4C": 1, "A4D": 2,
        "D1": 5
    },
    "A2D": {
        "A3A": 4, "A3B": 3, "A3C": 2, "A3D": 1,
        "A4A": 4, "A4B": 3, "A4C": 2, "A4D": 1,
        "D1": 4
    },
    "A3A": {
        "A3B": 1, "A3C": 2, "A3D": 3, 
        "A4A": 1, "A4B": 2, "A4C": 3, "A4D": 4,
        "D1": 6
    },
    "A3B": {
        "A3C": 1, "A3D": 2,
        "A4A": 2, "A4B": 1, "A4C": 2, "A4D": 3,
        "D1": 5
    },
    "A3C": {
        "A3D": 1,
        "A4A": 3, "A4B": 2, "A4C": 1, "A4D": 2,
        "D1": 4
    },
    "A3D": {
        "A4A": 4, "A4B": 3, "A4C": 2, "A4D": 1,
        "D1": 3
    },
    "A4A": {
        "A4B": 1, "A4C": 2, "A4D": 3,
        "D1": 5
    },
    "A4B": {
        "A4C": 1, "A4D": 2,
        "D1": 4
    },
    "A4C": {
        "A4D": 1,
        "D1": 3
    },
    "A4D": {
        "D1": 2
    }
}